Nadh is to the body what gasoline is to a car. It provides energy for the cells, allowing them to function properly.	nadh	Using an analogy, explain nadh to student who likes sports.
Nadh is like the fuel that powers an athlete's body. It provides energy for movement and helps muscles contract. Just as a car needs gasoline to run, an athlete needs nadh to perform well.	nadh	Using an analogy, explain nadh to student who likes sports.
Nadh is an important molecule in the body that helps to create energy. Just as athletes need good food and plenty of rest to perform their best, cells also need nadh for energy production. Without enough nadh, cells can't function properly and the body doesn't have enough energy to do what it needs to do.	nadh	Using an analogy, explain nadh to student who likes sports.
Proteins are like the muscles in our body. They are made up of smaller molecules called amino acids, and they perform many important tasks such as building new cells, repairing tissue, and helping to regulate our internal systems. Just like athletes need to eat a healthy diet full of protein to keep their muscles strong, our bodies need proteins from food to stay healthy.	proteins	Using an analogy, explain proteins to student who likes sports.
Think of proteins as the players on a sports team. Just like there are many different types of players on a sports team, there are many different types of proteins in our bodies. Each type of protein has a specific job to do, just like each type of player on a sports team does their own unique job. Some proteins help us move, some proteins help us fight infection, and others help us keep our cells healthy.	proteins	Using an analogy, explain proteins to student who likes sports.
Proteins are the athletes of the cell. They are responsible for most of the work that goes on in the cell and they need to be in top condition to do their job properly. Like an athlete, a protein has a specific role to play in the cell and needs the right nutrients (amino acids) to stay fit and healthy.	proteins	Using an analogy, explain proteins to student who likes sports.
DNA is like a playbook for athletes. It tells them what moves to make on the field and how to win the game.	dna	Using an analogy, explain dna to student who likes sports.
DNA is like the playbook for a sports team. It tells the players what to do on the field.	dna	Using an analogy, explain dna to student who likes sports.
DNA is like the instructions for assembling a sports team. The DNA contains all of the information necessary to create a player - their height, weight, position on the field, etc.	dna	Using an analogy, explain dna to student who likes sports.
Glycogen is like fuel for a car. The body stores glycogen in the muscles and liver. When you work out, your muscles use up the glycogen. After you work out, your muscles will rebuild the glycogen.	glycogen	Using an analogy, explain glycogen to student who likes sports.
Think of glycogen as a "gas tank" for your muscles. It's the fuel that helps power you through sports and other activities. When you eat foods with carbohydrates, your body stores some of those carbs as glycogen. During exercise, your muscles use up the glycogen they've stored. If you keep eating carbs while you're active, your body will keep replacing the glycogen it uses up.	glycogen	Using an analogy, explain glycogen to student who likes sports.
Glycogen is like a tank of gas for a car. It is the storage form of glucose in the body. Glucose is used by muscles for energy during exercise. The glycogen stores in the muscles are depleted as the muscles use up the glucose for energy. When these stores are depleted, the athlete "hit the wall" and experiences fatigue and muscle weakness.	glycogen	Using an analogy, explain glycogen to student who likes sports.
Endoplasmic reticulum is like a sports stadium. It's large and has a lot of space for things to happen. The endoplasmic reticulum is also where the game (or event) takes place. Just like in a sports stadium, there are lots of people involved in making sure the game goes smoothly - from the players on the field to the coaches and referees, and everyone in between. The endoplasmic reticulum plays an important role in cells, just like a sports stadium does in a community.	endoplasmic reticulum	Using an analogy, explain endoplasmic reticulum to student who likes sports.
Endoplasmic Reticulum (ER) is like the coach of a sports team. The ER helps to organize and coordinate the activities of the proteins within the cell. It also helps to produce new proteins that are needed by the cell.	endoplasmic reticulum	Using an analogy, explain endoplasmic reticulum to student who likes sports.
Endoplasmic reticulum is like a sports stadium. It's where the "game" of protein synthesis happens. The proteins are made in the "players' locker rooms" (the ribosomes) and then move out onto the field (the endoplasmic reticulum).	endoplasmic reticulum	Using an analogy, explain endoplasmic reticulum to student who likes sports.
The Golgi Apparatus is a bit like the referee during a soccer game. It helps to keep things organized and running smoothly by sorting and packaging proteins that have been created in the cell's ribosomes.	golgi	Using an analogy, explain golgi to student who likes sports.
Golgi is similar to the referees in a sports game. The referees are responsible for making sure that the game is played fairly and according to the rules. Golgi plays a similar role in cells by ensuring that proteins are properly processed and delivered to their correct destinations.	golgi	Using an analogy, explain golgi to student who likes sports.
The golgi apparatus is like the referee in a sport. It ensures that the game is played fairly and that the players are following the rules. It also helps to keep track of what is going on during the game.	golgi	Using an analogy, explain golgi to student who likes sports.
The plasma membrane is like a basketball net. It is the goal that the players are trying to shoot the ball into. The proteins and other molecules in the plasma membrane are like the defenders who try to block the shot.	plasma membrane	Using an analogy, explain plasma membrane to student who likes sports.
The plasma membrane can be compared to the walls of a basketball court. Just as the walls protect players and keep the ball in play, the plasma membrane protects cells and helps maintain cell function. The membranes are also elastic, meaning they can stretch and bounce back when pressure is applied. This analogy can help students understand how important the plasma membrane is for protecting cells and maintaining their functions.	plasma membrane	Using an analogy, explain plasma membrane to student who likes sports.
Plasma membrane can be thought of as a basketball net. Just as the net catches the ball and holds it in place, so too does plasma membrane interact with molecules that come into contact with it, holding them in place while allowing other substances to pass through.	plasma membrane	Using an analogy, explain plasma membrane to student who likes sports.
Lysosomes are like the "garbage collectors" of a cell. They break down old or damaged proteins and other cellular components into smaller pieces that can be recycled.	lysosome	Using an analogy, explain lysosome to student who likes sports.
Lysosomes are like little sports stadiums inside our cells. They are where the action happens, and they house all of the enzymes that break down proteins, fats, and carbohydrates.	lysosome	Using an analogy, explain lysosome to student who likes sports.
Lysosomes are like the "garbage collectors" of a cell. They break down things that the cell doesn't need anymore and recycle them into new molecules.	lysosome	Using an analogy, explain lysosome to student who likes sports.
Peroxisomes are like little sports stadiums in our cells. Just as a stadium is used for many different sporting events, peroxisomes can be used to carry out multiple tasks within the cell. They help us convert food into energy, get rid of toxins, and defend our cells against infection.	peroxisomes	Using an analogy, explain peroxisomes to student who likes sports.
Peroxisomes are like the referees of a sports game. They help to keep everything running smoothly and make sure that all the players are following the rules.	peroxisomes	Using an analogy, explain peroxisomes to student who likes sports.
Peroxisomes are like the referees in a sports game. They make sure that everything is going smoothly and that the rules are being followed.	peroxisomes	Using an analogy, explain peroxisomes to student who likes sports.
Mitochondria are the energy providers for cells in the body. They take in food and oxygen and turn them into energy that the cell can use to do its work. This is a bit like how a sports stadium needs workers who bring in food and drinks for the fans, as well as people to clean up after everyone has gone home. The mitochondria are those workers who provide energy for everything that goes on inside the cell.	mitochondria	Using an analogy, explain mitochondria to student who likes sports.
Mitochondria are like the engines in a car. They take in food and oxygen and turn them into energy that the body can use.	mitochondria	Using an analogy, explain mitochondria to student who likes sports.
Mitochondria can be thought of as the "power plants" of our cells. They are responsible for producing energy (in the form of ATP) that our cells need to function.	mitochondria	Using an analogy, explain mitochondria to student who likes sports.
Chloroplasts are like the players on a sports team. They work together to achieve a common goal- in this case, photosynthesis.	chloroplast	Using an analogy, explain chloroplast to student who likes sports.
Chloroplasts are the organelles in a plant cell that are responsible for photosynthesis. Just as athletes need to breathe in order to perform, plants need chloroplasts in order to convert sunlight into food.	chloroplast	Using an analogy, explain chloroplast to student who likes sports.
In the context of sports, chloroplasts can be thought of as the muscles in an athlete's body. Just like athletes need muscles to power their physical feats, plants need chloroplasts to turn sunlight into the energy they need to grow.	chloroplast	Using an analogy, explain chloroplast to student who likes sports.
The cytoskeleton is like the frame of a house. It provides support and helps to keep the shape of the cell. The cytoskeleton is made up of proteins called microtubules and actin filaments. These proteins can be compared to the beams and walls of a house, respectively.	cytoskeleton	Using an analogy, explain cytoskeleton to student who likes sports.
The cytoskeleton is like the skeleton of a sports player. It provides support and structure to the cell, just as bones do for the body. The cytoskeleton also helps the cell move around, just as muscles help players move their bodies.	cytoskeleton	Using an analogy, explain cytoskeleton to student who likes sports.
The cytoskeleton is like the frame of a house. It helps to hold the cells together and gives them their shape. The cytoskeleton also helps with cell movement and communication.	cytoskeleton	Using an analogy, explain cytoskeleton to student who likes sports.
ATP is like gasoline for a car. It provides the energy that the car needs to move. The same is true for our muscles. ATP provides the energy that our muscles need to move.	atp	Using an analogy, explain atp to student who likes sports.
ATP is like the fuel that powers a car. It's what makes it go. In the same way, ATP is what provides the energy for all of our muscles to work.	atp	Using an analogy, explain atp to student who likes sports.
Atp is like the gasoline that powers a car. It provides energy for the muscles to move and allows us to do things like run, jump, and lift weights.	atp	Using an analogy, explain atp to student who likes sports.
NADPH is like a sports team's "energy drink." It helps to produce energy in the cells, which is necessary for athletes (or anyone) to perform at their best.	nadph	Using an analogy, explain nadph to student who likes sports.
NADPH is like the fuel for a sports car. It helps the engine run smoothly and efficiently.	nadph	Using an analogy, explain nadph to student who likes sports.
Nadph is like oxygen for athletes. It helps them to breathe and perform at their best.	nadph	Using an analogy, explain nadph to student who likes sports.
Peroxysomes can be thought of as the "powerhouses" of the cell. They are small organelles that produce energy for the cell by breaking down molecules like glucose and fatty acids. This process is called oxidative phosphorylation, and it is something that happens in all cells - not just muscle cells!	peroxysome	Using an analogy, explain peroxysome to student who likes sports.
Peroxysomes are small organelles in the cell that help break down toxins. They are a little bit like the referees or umpires at a sports game. Just as these officials make sure that the game is played fairly and according to the rules, peroxysomes help keep the cell running smoothly by breaking down harmful toxins.	peroxysome	Using an analogy, explain peroxysome to student who likes sports.
Peroxysomes are the "quarterbacks" of the cell - they direct traffic and help different parts of the cell communicate with each other.	peroxysome	Using an analogy, explain peroxysome to student who likes sports.
Mytochondria are the mitochondria in a cell. They are important because they help create energy for the cell to use. This is similar to how sports players need energy to perform well. Mytochondria help create this energy in cells, just like how athletes need fuel to run and play well.	mytochondria	Using an analogy, explain mytochondria to student who likes sports.
Mytochondria are the "powerhouses" of cells, similar to how a sports team's power-forward is essential for scoring goals. Mytochondria produce energy for the cell by converting glucose and oxygen into adenosine triphosphate (ATP). Without mytochondria, cells would not be able to function.	mytochondria	Using an analogy, explain mytochondria to student who likes sports.
Mytochondria are the parts of the cells that help with energy production. This is similar to how a sports team relies on different players to help it win. The quarterback throws the ball, the wide receivers catch it, and the linemen protect the quarterback. Each player has a specific job to do in order for the team to be successful. In much the same way, mytochondria play an important role in helping cells produce energy.	mytochondria	Using an analogy, explain mytochondria to student who likes sports.
Electric forces are like two magnets. If you have two magnets and you try to push them together, they will repel each other.	electric forces	Using an analogy, explain electric forces to student who likes sports.
Electric forces are like the athletes on a sports team. The athletes work together to score points and win the game. Electric forces work together to make sure that positive charges move in one direction and negative charges move in another direction.	electric forces	Using an analogy, explain electric forces to student who likes sports.
Electricity is like a bunch of people in a stadium cheering for their favorite team. The electricity is flowing through the wires in the stadium, and when someone cheers, it creates an electric force that makes other people cheer too.	electric forces	Using an analogy, explain electric forces to student who likes sports.
An orbital can be thought of as the path that an electron takes around the nucleus. The hydrogen atom has one electron and it occupies the first orbit. This orbit is like a track around a stadium. The electron travels around the nucleus in a circular path, just like a runner on a track.	hydrogen electron's orbital	Using an analogy, explain hydrogen electron's orbital to student who likes sports.
When an electron is in an orbital, it's kind of like a player on a sports team. The orbital is like the team's playing field, and the electron is like one of the players on that field. Just as different players can be in different places on a playing field at any given time, electrons can be in different places within their orbitals at any given time.	hydrogen electron's orbital	Using an analogy, explain hydrogen electron's orbital to student who likes sports.
Orbitals are like the different sections of a stadium. The higher up in the stands you sit, the further away you are from the field. Electrons orbit around the nucleus just like spectators sitting in the stands. The closer an electron is to the nucleus, the more energy it has. Just like someone who is close to the field has a better view than someone who is far away, electrons that are close to the nucleus have more energy and can interact more with other atoms.	hydrogen electron's orbital	Using an analogy, explain hydrogen electron's orbital to student who likes sports.
A first line of defense in the body is similar to a team of defensive players in football. The players are positioned in front of the goal (the end zone) and their job is to stop the opposing team from scoring. Similarly, the first line of defense in the body consists of a group of cells and tissues that work together to protect us from infection and disease. Their job is to prevent bacteria and other foreign invaders from entering our bodies and causing harm.	first line of defense in the body	Using an analogy, explain first line of defense in the body to student who likes sports.
The first line of defense in the body is similar to a team of football players. The players are lined up on the front line, ready to tackle the opposing player and stop them from advancing. Similarly, the first line of defense in the body is made up of cells that are specialized for fighting off infection and protecting against disease. These cells work together to identify and destroy any invaders that attempt to enter the body.	first line of defense in the body	Using an analogy, explain first line of defense in the body to student who likes sports.
The first line of defense in the body is similar to a team of players in sports. The players work together to protect the goal and keep the other team from scoring. Similarly, the first line of defense in the body protects against infection and disease by working together to keep germs out.	first line of defense in the body	Using an analogy, explain first line of defense in the body to student who likes sports.
One way to think about macrophages is as the "team doctors" of the immune system. They're responsible for identifying and attacking any bacteria, viruses, or other invaders that might be causing harm. Like a good team doctor, they're also quick to help injured cells get back on their feet.	macrophages	Using an analogy, explain macrophages to student who likes sports.
Macrophages are like the "police force" of the body. They patrol and keep track of what is happening in all different parts of the body, looking for anything that might be abnormal or dangerous. When they find something, they take action to get rid of it.	macrophages	Using an analogy, explain macrophages to student who likes sports.
Macrophages are like the big guys on the basketball court. They are tall and muscular, and they can really move around quickly. They play an important role in the game by blocking shots and grabbing rebounds.	macrophages	Using an analogy, explain macrophages to student who likes sports.
A t-helper cell is like an assistant coach on a sports team. They help the main coach by giving them support and advice. They also help to motivate the players and keep them focused on the game.	t-helper cells	Using an analogy, explain t-helper cells to student who likes sports.
T-helper cells are like the quarterback on a football team. They direct and coordinate the other players to make sure that they all work together to achieve the goal of scoring points.	t-helper cells	Using an analogy, explain t-helper cells to student who likes sports.
A t-helper cell is an important part of the immune system. It helps to coordinate and direct other cells in the immune response. In a way, it can be thought of as the quarterback on a football team. The quarterback doesn't necessarily do all of the work himself, but he coordinates and directs the other players so that they can work together to achieve their goal.	t-helper cells	Using an analogy, explain t-helper cells to student who likes sports.
B lymphocytes are like the offensive linemen on a football team. They provide protection for other players by creating a barrier between them and the opposing team. In the same way, b lymphocytes protect other cells in the body from invading viruses and bacteria.	b-lymphocytes	Using an analogy, explain b-lymphocytes to student who likes sports.
B-lymphocytes are like linebackers on a football team. They are big, strong cells that help protect the body from infection. Like all of the players on a football team, they work together to achieve a common goal - in this case, defending the body against infection.	b-lymphocytes	Using an analogy, explain b-lymphocytes to student who likes sports.
B-lymphocytes are like the quarterbacks on a football team. They are responsible for calling the plays and directing the rest of the players on the field.	b-lymphocytes	Using an analogy, explain b-lymphocytes to student who likes sports.
Cytotoxic t-lymphocytes can be thought of as the "defense" players on a sports team. They are responsible for attacking and destroying any cells (like opposing players) that are seen as a threat to the body.	cytotoxic t-lymphocytes	Using an analogy, explain cytotoxic t-lymphocytes to student who likes sports.
Cytotoxic T-lymphocytes are like the "team captain" of the immune system. They help to direct other immune cells, such as B-cells and macrophages, to destroy infected or cancerous cells. Like a good team captain, cytotoxic T-lymphocytes are very effective at their job and can quickly eliminate diseased cells from the body.	cytotoxic t-lymphocytes	Using an analogy, explain cytotoxic t-lymphocytes to student who likes sports.
Cytotoxic t-lymphocytes are like the defensive linemen on a football team. They are responsible for attacking and destroying any cells that are not supposed to be in the body.	cytotoxic t-lymphocytes	Using an analogy, explain cytotoxic t-lymphocytes to student who likes sports.
If someone wanted to describe the invasion of bacteria, they might use a sports analogy. Imagine that there are two teams playing against each other. The first team is made up of strong and fit players, while the second team is made up of small and weak players. The first team easily wins the game, as they are much stronger than their opponents. This is similar to how bacteria can invade an animal or human body - because they are much smaller and weaker than the cells in our bodies, they can easily overcome them and cause infection.	invasion of bacterias	Using an analogy, explain invasion of bacterias to student who likes sports.
If bacterial invasion is like a sports team invading another team's territory, the bacteria are using special tactics and strategies to overcome the defending forces and take over the area. The bacteria may produce toxins that kill or disable the cells of the host tissue, making it easier for them to multiply. They may also use enzymes to break down tissues so they can absorb nutrients from them.	invasion of bacterias	Using an analogy, explain invasion of bacterias to student who likes sports.
A bacteria invasion is very similar to a sports team invading another team's territory. The bacteria invade and take over the cells of the host organism, using them for their own purposes. Like a sports team, the bacteria use energy and resources from the invaded cells to grow and spread.	invasion of bacterias	Using an analogy, explain invasion of bacterias to student who likes sports.
When you watch a sports game on TV, the athletes are constantly moving. This is because they are reacting to what's going on around them. The athlete's movements are controlled by electrical signals that start in their brain and travel down their spinal cord to their muscles. These signals tell the muscles when and how to move, allowing the athlete to react quickly to what's happening on the field.The same thing happens inside your body when you're walking or running. Your brain sends electrical signals down your spinal cord telling your muscles when and how to move. These signals allow you to react quickly and smoothly to the changing environment around you.	action potential	Using an analogy, explain action potential to student who likes sports.
Action potential can be thought of as an "electrical signal" that travels down the neuron. This electrical signal is much like a wave that starts at one end of the neuron and moves down to the other end. The "high point" of this wave is called the action potential, and it's what causes the neuron to fire (or send a message).	action potential	Using an analogy, explain action potential to student who likes sports.
When a sports fan watches their favorite team, they get really excited and their heart starts beating faster. This is because the brain sends signals to the heart telling it to beat faster. The same thing happens when someone sees or hears something that excites them. The brain sends out action potentials (signals) that travel down nerves until they reach muscles, causing them to contract.	action potential	Using an analogy, explain action potential to student who likes sports.
Chromatography can be thought of as a way to separate the various chemicals in a sports drink by their different weights. Just like athletes competing in different events according to their weight, the various chemicals in the sports drink are separated according to how heavy they are. The lighter molecules travel faster than the heavier ones and end up at the top of the glass jar, while the heaviest molecules stay at the bottom.	experiment of chromatography	Using an analogy, explain experiment of chromatography to student who likes sports.
Chromatography is like when two basketball teams play each other. The players on the court are the molecules and the fans in the stands are the solvent. During a game, different players might cross the half-court line at different speeds. This is analogous to how molecules move differently through a solvent during chromatography. Some players might stay near one side of the court, while others quickly cross to the other side. Just as basketball teams have their own individual strategies, so do molecules undergo unique behaviors during chromatography due to their chemical makeup	experiment of chromatography	Using an analogy, explain experiment of chromatography to student who likes sports.
One could think of chromatography as a way to "separate" the various compounds that are in a given substance. For example, if you have a vial of sports drink, and you want to analyze the contents to see how much sugar, caffeine, and other compounds are present, chromatography can help you do that. You would start by putting some of the sports drink on a strip of paper (the "stationary phase"), then spraying or dipping it into a solvent (the "mobile phase"). The solvent will travel up the paper carrying with it any molecules that are soluble in it. As different molecules move at different speeds through the solvent, they will be separated out on the paper based on their size and polarity. So larger, more polar molecules (like sugars) will move slower than smaller, less polar molecules (like caffeine). By looking at which bands are present on the strip of paper after separation has occurred, you can get an idea of how much each compound is present in the original sample.	experiment of chromatography	Using an analogy, explain experiment of chromatography to student who likes sports.
Stars are like sports players. As they use up their energy, they "retire" from the main sequence and become white dwarfs, neutron stars, or black holes.	main-sequence lifetimes of stars	Using an analogy, explain main-sequence lifetimes of stars to student who likes sports.
Stars are similar to athletes in that they have a limited lifetime. The main sequence lifetime of a star is the amount of time it spends burning hydrogen in its core. This process lasts for billions of years, but eventually the star will run out of fuel and die.	main-sequence lifetimes of stars	Using an analogy, explain main-sequence lifetimes of stars to student who likes sports.
Stars are like athletes in that they have a certain amount of energy that they can use before they "die." Young stars, like rookie athletes, have a lot of energy and can last for a long time. Middle-aged stars, like veteran athletes, still have some energy but not as much as young stars. Old stars, like retired athletes, don't have much energy left and will die relatively soon.	main-sequence lifetimes of stars	Using an analogy, explain main-sequence lifetimes of stars to student who likes sports.
In sports, the nucleus is the most important part of the team. It is made up of the best players and they are responsible for leading the team to victory. The nucleus determines how successful a team will be. In much the same way, the nucleus of an atom is made up of its most important particles and it determines how successful that atom will be.	nucleus	Using an analogy, explain nucleus to student who likes sports.
Nucleus is the most important part of an atom. Just like a quarterback is the most important player on a football team, the nucleus is the most important part of an atom. The nucleus contains protons and neutrons which control how atoms behave.	nucleus	Using an analogy, explain nucleus to student who likes sports.
Nucleus is like the quarterback of a football team. He directs and oversees all the other players on the field. Similarly, the nucleus controls everything that goes on in a cell.	nucleus	Using an analogy, explain nucleus to student who likes sports.
Ribosomes can be thought of as the "team" that assembles proteins. The instructions for assembling a protein are written out on a "recipe" or gene, and this information is then read by the ribosomes who put together the correct sequence of amino acids to create the desired protein.	ribosomes	Using an analogy, explain ribosomes to student who likes sports.
Ribosomes can be thought of as the "production line" of a factory. The DNA in the nucleus is like the blueprint for making a product. The ribosomes take this blueprint and use it to create proteins, which are necessary for all cellular functions. Just as different machines are needed to manufacture different products in a factory, there are different types of ribosomes that are responsible for creating different proteins.	ribosomes	Using an analogy, explain ribosomes to student who likes sports.
Ribosomes are to a cell what a quarterback is to a football team. They are the small, but important players that play a major role in getting the job done. Ribosomes are responsible for reading instructions from messenger RNA (mRNA) and assembling proteins accordingly. Just like how a good quarterback can make all the difference in winning or losing a game, ribosomes play an essential role in protein synthesis and ensuring that cells function properly.	ribosomes	Using an analogy, explain ribosomes to student who likes sports.
The golgi apparatus is like the referee of a sports game. It helps to ensure that the game is played fairly and smoothly.	golgi apparatus	Using an analogy, explain golgi apparatus to student who likes sports.
The golgi apparatus can be thought of as an assembly line in a factory. The different parts that make up the final product are brought in one end, and they are assembled and finished before being shipped out the other end.	golgi apparatus	Using an analogy, explain golgi apparatus to student who likes sports.
The golgi apparatus can be thought of as the "filing cabinet" for a cell. It is responsible for sorting and packaging proteins that are produced in the endoplasmic reticulum. These proteins then exit the cell via vesicles.	golgi apparatus	Using an analogy, explain golgi apparatus to student who likes sports.
Lysosomes are like the "trash cans" of a cell. They are filled with enzymes that can break down proteins, lipids, and nucleic acids. This allows them to recycle these molecules back into useful materials for the cell.	lysosomes	Using an analogy, explain lysosomes to student who likes sports.
Lysosomes are like the "garbage collectors" of a cell. They break down proteins and other molecules that are no longer needed, and recycle their components. This helps keep the cell healthy and functioning properly. Lysosomes can be thought of as similar to a sports arena's janitorial staff - they clean up after the game is over, so everything is ready for the next event.	lysosomes	Using an analogy, explain lysosomes to student who likes sports.
Lysosomes are like the "garbage collectors" of a cell. They break down and recycle old or damaged proteins, lipids, and nucleic acids. This helps keep the cell healthy and functioning properly. Lysosomes are often compared to little recycling trucks that go around picking up garbage!	lysosomes	Using an analogy, explain lysosomes to student who likes sports.
The nuclear envelope is like the protective shield around a sports stadium. It helps to keep out unwanted elements and protect the inside of the stadium. In the same way, the nuclear envelope helps to protect the nucleus of a cell from outside influences and keeps everything inside safe.	nuclear envelope	Using an analogy, explain nuclear envelope to student who likes sports.
A nuclear envelope is similar to a sports arena. It's a large, enclosed space where events take place. The nuclear envelope surrounds the nucleus of the cell, just as an arena surrounds the playing field or court. Within the nucleus, chromosomes are located in structures called nucleoli.	nuclear envelope	Using an analogy, explain nuclear envelope to student who likes sports.
The nuclear envelope is like the walls of a stadium. It surrounds and protects the nucleus, just as the stadium walls protect the athletes inside.	nuclear envelope	Using an analogy, explain nuclear envelope to student who likes sports.
A vacuole is kind of like a locker room for the cells in your body. Just as athletes need a place to store their gear and change into their uniforms, cells need a place to store their extra cargo and change into new cell types. The vacuoles do this by expanding or shrinking to accommodate the needs of the cells around them.	vacuoles	Using an analogy, explain vacuoles to student who likes sports.
The vacuoles are like the sports stadiums in which the sports games take place. The vacuoles are where the cells store their food, water, and other materials.	vacuoles	Using an analogy, explain vacuoles to student who likes sports.
A vacuole is sort of like a sports stadium. It's a big, open space where things can happen. In the vacuole, cells can store food, waste products, and water. It's also a place where important cellular processes take place.	vacuoles	Using an analogy, explain vacuoles to student who likes sports.
Cytoplasm is like the players on a sports team. It is made up of many smaller parts (like cells) that work together to create something larger. The cytoplasm surrounds and supports the nucleus, just like the players surround and support the ball carrier on a football field.	cytoplasm	Using an analogy, explain cytoplasm to student who likes sports.
Cytoplasm is sort of like the players on a sports team. The cytoplasm contains all of the organelles (like the players' organs), and it surrounds and supports them (like how a player's body surrounds and supports their organs). Cytoplasm also provides nutrients to the organelles (just like how food and water provide nutrients to athletes).	cytoplasm	Using an analogy, explain cytoplasm to student who likes sports.
Cytoplasm is like the players on a sports team. The players are all important and work together to make the team successful. Cytoplasm organizes and directs the activities of the cell, just as a coach does for a sports team.	cytoplasm	Using an analogy, explain cytoplasm to student who likes sports.
Chromosomes can be thought of as the genetic players on a sports team. These players are important for determining how the team functions and what their abilities are. In the same way, chromosomes play an important role in determining an individual's characteristics and overall health.	chromosome	Using an analogy, explain chromosome to student who likes sports.
Chromosomes are like the players on a sports team. They have specific roles to play and work together to achieve the goal of winning the game.	chromosome	Using an analogy, explain chromosome to student who likes sports.
Chromosomes are like the players on a sports team. Each chromosome has its own unique set of instructions (like how to play their sport), and together they work as a team to make sure the cell functions properly.	chromosome	Using an analogy, explain chromosome to student who likes sports.
Cytosol can be thought of as the sports arena where all the action happens. The proteins, enzymes, and other molecules that make up the cellular machinery are located in the cytosol. This is also where nutrients enter the cell and waste products exit.	cytosol	Using an analogy, explain cytosol to student who likes sports.
The cytosol is like the water in a pool. It surrounds all of the other parts of the cell and helps them to move around.	cytosol	Using an analogy, explain cytosol to student who likes sports.
Cytosol is like the sports arena where all the action happens. This is where all of the players are and where the game is played. The cytosol contains everything that is needed for the cells to function, including proteins, enzymes, and other chemicals.	cytosol	Using an analogy, explain cytosol to student who likes sports.
A cell is like a small community of people who all work together to achieve a common goal. Just as different people in a community have different skills and roles, so do the cells in our bodies. Cells are constantly working together to keep us healthy and functioning properly.	cell	Using an analogy, explain cell to student who likes sports.
A cell is like a small sports stadium. It has a lot of people inside it, and they are all doing different things. Some people are sitting down, some people are standing up, and some people are running around. The cell has an area where the people sit down (the nucleus), an area where the people stand up (the cytoplasm), and an area where the people run around (the membrane).	cell	Using an analogy, explain cell to student who likes sports.
A cell is like a small sports stadium. It has an area where people can sit and watch the game, and a playing field where the action happens. The cells in our bodies are filled with organelles - like little sports stadiums within the cell - that carry out all the important functions of life.	cell	Using an analogy, explain cell to student who likes sports.
If you think of a cell as a large stadium, then the vesicles would be like the people in the stands. They are small and can move around quickly within the stadium.	vesicles	Using an analogy, explain vesicles to student who likes sports.
A vesicle can be thought of as a small compartment in the cell. This compartment can hold different molecules that help the cell to function. For example, proteins that are important for the cell's survival or signaling molecules may be stored inside vesicles. Vesicles can also help to regulate the exchange of materials between cells and their environment.	vesicles	Using an analogy, explain vesicles to student who likes sports.
A vesicle is a small, spherical sac that contains fluid. Vesicles can be found in many different places throughout the body, including within cells and between cells. They are often used to transfer materials from one part of the cell to another or from one cell to another.	vesicles	Using an analogy, explain vesicles to student who likes sports.
A cell wall is a bit like the concrete surrounding a sports stadium. It provides support and protects the cells inside.	cell wall	Using an analogy, explain cell wall to student who likes sports.
The cell wall can be thought of as the boundary or outer limit of a cell. It is a tough, flexible layer that protects the cells and helps keep them in shape. The cell wall is made up of peptidoglycan (a type of carbohydrate) and proteins, and it varies in thickness depending on the type of cell. For example, red blood cells don't have a cell wall, while bacteria do.	cell wall	Using an analogy, explain cell wall to student who likes sports.
Cell walls are like the fences in a sports stadium. They help to keep things organized and separate. In the case of cells, the cell wall helps to keep the cell's contents (including DNA) from leaking out.	cell wall	Using an analogy, explain cell wall to student who likes sports.
Cells can be compared to players on a sports team. Just as each player has a specific role in order for the team to be successful, cells also have specific roles within the body that are necessary for survival. Cells work together to create muscles, bones, organs and other tissues; much like athletes work together to score points and win games.	cells	Using an analogy, explain cells to student who likes sports.
Cells are like the players on a sports team. Just as each cell has a specific job to do, each player on a sports team has a specific role to play. Cells work together to create tissues and organs that allow us to move and function. Similarly, athletes work together to score goals or touchdowns and win games.	cells	Using an analogy, explain cells to student who likes sports.
Cells are the basic units of life just as players are the basic unit of sports. Cells work together to make up tissues and organs, just as players work together on a team to make up a sport. Cells can be injured or die, just as players can get injured or die.	cells	Using an analogy, explain cells to student who likes sports.
The cell membrane is like a wall around the soccer field. It protects the players from getting hurt and keeps the ball in play.	cell membrane	Using an analogy, explain cell membrane to student who likes sports.
Cell membranes are like the walls of a stadium. They protect the cells and keep the different parts of the cell separated from each other. The cell membrane is also responsible for letting things in and out of the cell, just like how people can go in and out of the stadium through the gates.	cell membrane	Using an analogy, explain cell membrane to student who likes sports.
The cell membrane is like a goalie in sports. It protects the cell and its contents from things that could harm it, like bacteria or other toxins. Just as a goalie blocks shots on goal, the cell membrane blocks things from entering or leaving the cell.	cell membrane	Using an analogy, explain cell membrane to student who likes sports.
Golgi body can be thought of as the "trainer" for a sports team. It helps to prepare and condition the players so they are ready for competition. The Golgi apparatus is responsible for modifying and packaging proteins that will be used by the cell. Just like a good coach, it ensures that the athletes are physically prepared and have all the necessary tools to win.	golgi body	Using an analogy, explain golgi body to student who likes sports.
Golgi body can be thought of as the "coach" or "manager" of a sports team. It is responsible for organizing and coordinating the activities of the other players on the team (the cells). It also oversees the production of proteins and other molecules that are necessary for effective play.	golgi body	Using an analogy, explain golgi body to student who likes sports.
The Golgi body is a lot like the referee in a sports game. It's responsible for making sure everything runs smoothly and that the players are following the rules. It also helps to ensure that the game goes as planned.	golgi body	Using an analogy, explain golgi body to student who likes sports.
If capacitance is like a basketball team, then the electric field would be the players on the court. Just as the players need space to run around and play their game, the electric field needs space to exist (between the capacitor plates). The more players on the court, or in this case, electrons on one plate of a capacitor, the greater force they have to push against each other. This is why capacitors with more surface area (more electrodes) store more charge than those with less.	capacitance	Using an analogy, explain capacitance to student who likes sports.
The capacitance of a capacitor is like the amount of water that can be held in a bucket. The more water that is poured into the bucket, the higher the water level rises. In the same way, the more electric charge that is put into a capacitor, the higher its voltage level becomes.	capacitance	Using an analogy, explain capacitance to student who likes sports.
One way to think of capacitance is as a kind of "electricity storage tank." Just as a reservoir stores water for later use, a capacitor stores electric charge for later use. The bigger the capacitor, the more charge it can store.	capacitance	Using an analogy, explain capacitance to student who likes sports.
Electric current is like the flow of athletes in a stadium. Just as athletes move around and flow through the stadium, electric current moves through wires.	electric current	Using an analogy, explain electric current to student who likes sports.
Electric current is similar to a soccer ball. Just as the soccer ball needs energy (from the person kicking it) in order to move forward, electric current needs energy (from the battery) in order to move through wires. Just like how different parts of the soccer field affect how the ball moves (for example, if its kicked near a wall, it will bounce back), electric currents are affected by different materials they travel through. For example, metal wires allow electricity to flow quickly and easily, while rubber or plastic insulation slows down the current.	electric current	Using an analogy, explain electric current to student who likes sports.
Electricity is a lot like sports. When you watch a game on TV, the pictures that you see are made up of lots of tiny dots called pixels. These pixels are switched on and off really quickly to create the image that you see on the screen. Electricity works in a very similar way - it's just made up of tiny particles called electrons instead of pixels! When an electron flows through a wire, it creates what we call an electric current.	electric current	Using an analogy, explain electric current to student who likes sports.
The voltage of a battery or power supply is like the amount of pressure that is put on water to come out of a hose. Just like with water, more pressure (voltage) means more force (amperage) will be available to do work.	voltage	Using an analogy, explain voltage to student who likes sports.
A good analogy for voltage would be to compare it to the score of a sports game. Just as the score changes as each play unfolds, voltage is constantly changing as electrons flow through a circuit. Voltage represents how hard someone is pushing (or pulling) on an electric current.	voltage	Using an analogy, explain voltage to student who likes sports.
When two teams play a game of football, they create an electric field between them. This electric field is caused by the charges on the players and in the ball. The higher the voltage (the number of charges per unit area), the stronger this electric field will be.	voltage	Using an analogy, explain voltage to student who likes sports.
A cell is like a sports team. The cells in our body work together to carry out the specialized functions that keep us alive. Cells communicate with one another by sending chemical signals, just as players on a sports team use hand signals to send messages to their teammates.	specialization and communication in a cell	Using an analogy, explain specialization and communication in a cell to student who likes sports.
In a sports team, there are many players who specialize in different positions. For example, some players may be good at catching the ball while others may be better at throwing it. But each player needs to communicate with the other players in order for the team to succeed. The catcher has to tell the pitcher when to throw the ball and where to aim it, and the outfielder needs to let the shortstop know when they're going to catch a fly ball.	specialization and communication in a cell	Using an analogy, explain specialization and communication in a cell to student who likes sports.
In a cell, specialization and communication are like the different players on a sports team. Each player has a specific job to do in order for the team to be successful. Players need to communicate with each other in order to know what their next move should be.	specialization and communication in a cell	Using an analogy, explain specialization and communication in a cell to student who likes sports.
Kirchoff's Voltage Law states that the sum of all voltages in a closed loop must be zero. This law is similar to the concept of equilibrium in sports, where the total force on an object must be zero for it to remain stationary.	kirchoff's voltage law	Using an analogy, explain kirchoff's voltage law to student who likes sports.
If someone is keeping track of the score in a game, they are following Kirchhoff's Voltage Law. The law states that the sum of all voltages in a closed loop must be zero. This means that no matter what path electricity takes through a circuit, the voltage at the end points will always add up to zero.	kirchoff's voltage law	Using an analogy, explain kirchoff's voltage law to student who likes sports.
In order for a sports team to win, they need to score more points than the other team. In the same way, in an electrical circuit, the voltage (or potential difference) is what drives the current through the circuit. So in order for a circuit to work properly, it needs to have a higher voltage at one end than at the other.	kirchoff's voltage law	Using an analogy, explain kirchoff's voltage law to student who likes sports.
A density wave is similar to a human wave at a sports game. Just as people move up and down in unison at a game, particles in a gas or liquid also move up and down together. The difference is that the movement of the particles is not caused by people standing up and sitting down, but instead by forces between the particles themselves.	nature of a density wave	Using an analogy, explain nature of a density wave to student who likes sports.
A density wave is like a large crowd of people at a sporting event. The people are all packed together in one area, and then they slowly spread out as more and more people arrive. The same thing happens with density waves. They start off being very compact, but as time goes on they gradually become less dense.	nature of a density wave	Using an analogy, explain nature of a density wave to student who likes sports.
A density wave is like a crowd of people at a sports game. The people are all packed together in one area, and then they slowly spread out until they are evenly spread throughout the stadium.	nature of a density wave	Using an analogy, explain nature of a density wave to student who likes sports.
Enzymes are like the referees in a game of basketball. They ensure that the game is played fairly and that all of the players follow the rules. Enzymes also make sure that the game progresses smoothly, without any stoppages. In the same way, enzymes help to keep biochemical reactions running smoothly, ensuring that all of the molecules involved interact properly.	enzymes	Using an analogy, explain enzymes to student who likes sports.
Enzymes are like athletes. They are very good at doing a specific job and they can do it over and over again without getting tired. Enzymes help reactions happen quickly and smoothly so that the cells in our bodies can function properly.	enzymes	Using an analogy, explain enzymes to student who likes sports.
Enzymes are like the referees of a sporting event. They make sure that everything goes smoothly and fairly. Enzymes help to keep things running smoothly in our bodies by helping chemical reactions occur.	enzymes	Using an analogy, explain enzymes to student who likes sports.
Your brain is like a muscle. The more you use it, the stronger it gets. Active memory is like working out at the gym. You have to use your muscles regularly in order for them to stay strong and healthy. The same goes for your active memory system - if you don't use it, you'll lose it!	human active memory system	Using an analogy, explain human active memory system to student who likes sports.
Active memory can be thought of as an athletes working memory. Just as athletes need to keep track of a number of things simultaneously while they are performing, our active memory system allows us to store and process information at the same time. This is done by maintaining a small amount of information in our short-term memory (similar to a mental to do list) and constantly updating it as new information comes in. We can then use this information to make decisions and solve problems.	human active memory system	Using an analogy, explain human active memory system to student who likes sports.
Your brain can be thought of as a muscle. Just like any other muscle in your body, the more you use it, the stronger it becomes. The same is true for your brain; the more you exercise your memory, the better it will perform. Active recall involves actively remembering information by retrieving and using it. This strengthens the neural pathways between neurons involved in memory formation and storage. As a result, recalling information becomes easier each time you do it.	human active memory system	Using an analogy, explain human active memory system to student who likes sports.
The rate-determining step is the part of a reaction that determines how fast the reaction will happen. This is often the slowest step in a reaction, and so it can be difficult to speed up a reaction by changing this step. For example, in a race, the runners might be able to speed up by running faster, but they cannot make their opponents run slower.	rate-determining step of a reaction	Using an analogy, explain rate-determining step of a reaction to student who likes sports.
The rate-determining step is like the quarterback in a football game. The quarterback determines how fast the team can move down the field and score points. In the same way, the rate-determining step controls how quickly a reaction can take place.	rate-determining step of a reaction	Using an analogy, explain rate-determining step of a reaction to student who likes sports.
In many chemical reactions, the rate-determining step is the slowest step. This means that the speed of the reaction depends on how quickly that particular step can occur. For example, imagine a football game where one team is trying to score a touchdown. The rate-determining step would be the player running down the field with the ball. If he moves slowly, then it will take longer for his team to score a touchdown. However, if he runs quickly down the field, then his team will score faster.	rate-determining step of a reaction	Using an analogy, explain rate-determining step of a reaction to student who likes sports.
Column chromatography can be thought of as a high-tech sporting event, where the objective is to move a small "object" (the compound being purified) through a long "track" as quickly and efficiently as possible. The track is filled with obstacles (known as stationary phase material), which the object must avoid if it wants to reach the finish line (the collection vessel). Like any good athlete, the object will use all of its energy and skills to make it to the end; in this case, that means using its own natural properties (e.g., polarity, size, shape) to interact with certain parts of the track more than others. The end result is a race between all of the different compounds in solution, each vying for supremacy on their particular section of the track.	column chromatography	Using an analogy, explain column chromatography to student who likes sports.
Column chromatography can be thought of as a sports referee. The referee is responsible for making sure the game is played fairly and accurately. In the same way, column chromatography ensures that the separation of molecules in a sample occurs correctly and without bias.	column chromatography	Using an analogy, explain column chromatography to student who likes sports.
Column chromatography is like when two basketball teams play each other. The players on one team try to get the ball to their teammate who is standing in a column (like in a column of scrimmage), and then that player tries to make a basket. If they miss, the other team gets possession of the ball.	column chromatography	Using an analogy, explain column chromatography to student who likes sports.
Chemical equilibrium is like a balance in sports. If one team starts to score more points, the other team has to work harder to catch up and maintain the balance. The same thing happens with chemical reactions. When one reaction starts to produce more products than the other reaction, the products of the first reaction begin to accumulate until both reactions reach equilibrium.	dynamic chemical equilibrium	Using an analogy, explain dynamic chemical equilibrium to student who likes sports.
Dynamic chemical equilibrium is like two opposing teams in a sports game. The teams are constantly competing against each other, but they are also working together. There is always a balance between the two teams and neither one can completely dominate the other. In the same way, there is a balance between the reactants and products in a chemical reaction. The reactants are always competing with each other to form products, but the products are also competing with each other to reform reactants. This keeps the reaction going until all of the reactants have been used up.	dynamic chemical equilibrium	Using an analogy, explain dynamic chemical equilibrium to student who likes sports.
The equilibrium between the offensive and defensive players on a football field is an example of dynamic chemical equilibrium. The offensive players (the reactants) are constantly trying to advance down the field, while the defensive players (the products) are trying to stop them. As long as there is no big upset (like a fumble or interception), the balance between offense and defense will stay relatively stable.	dynamic chemical equilibrium	Using an analogy, explain dynamic chemical equilibrium to student who likes sports.
A vacuole is like a large, empty space in the center of a basketball. It's not something that you can see or feel, but it's there and it affects how the ball behaves.	vacuole	Using an analogy, explain vacuole to student who likes sports.
A vacuole is a lot like a sports stadium. It's an enclosed space where something can happen. In the case of a vacuole, things happen inside the cell like proteins being made and other important cellular processes taking place.	vacuole	Using an analogy, explain vacuole to student who likes sports.
A vacuole is like a locker room for the cells in your body. It's a place where they can store things, like food or water, and get ready to do their job.	vacuole	Using an analogy, explain vacuole to student who likes sports.
One way to think about transport vesicles is to compare them to basketballs. Just as a basketball can be used to carry goods (e.g., water, sports equipment) from one part of a playing area to another, transport vesicles can be used to carry goods (e.g., proteins, lipids) within and between cells.	transport vesicles	Using an analogy, explain transport vesicles to student who likes sports.
In sports, a vesicle would be like a basketball. It is round and filled with something that can help it move around quickly. In the body, transport vesicles carry nutrients and other important materials to different parts of the cell.	transport vesicles	Using an analogy, explain transport vesicles to student who likes sports.
Imagine that you are a professional basketball player. In order to play in the game, you need to be physically present at the stadium. To get there, you have to take a series of steps: You first have to leave your house and walk or drive to the stadium. Once you're there, you go through security and then head into the locker room. Finally, you step out onto the court and start playing.Now imagine that instead of walking or driving yourself to the stadium, someone else does it for you. That's essentially what happens with transport vesicles: they shuttle proteins and other materials from one part of the cell to another.	transport vesicles	Using an analogy, explain transport vesicles to student who likes sports.
A proto-oncogene is like a coach of a sports team. The coach helps to train and prepare the players for the game. If the coach is good, the players are likely to do well. However, if something happens to the coach (e.g., they get sick), then the team may not be as successful.	proto-oncogenes	Using an analogy, explain proto-oncogenes to student who likes sports.
Proto-oncogenes can be thought of as the "coach" of a cancer cell. They help to regulate how fast the cancer cells grow and divide, and they also help to keep the cells organized. When these genes become mutated, they can no longer properly control the growth of cancer cells, which can lead to uncontrolled cell growth and tumor formation.	proto-oncogenes	Using an analogy, explain proto-oncogenes to student who likes sports.
A proto-oncogene would be like a professional basketball player. This person has the potential to become a great player, but they need the right environment and coaching in order to reach their full potential. If someone with proto-oncogenes doesn't get the support they need, their cancer cells may not develop into tumors.	proto-oncogenes	Using an analogy, explain proto-oncogenes to student who likes sports.
An oncogene can be thought of as a "super gene" that helps cancer cells grow and divide uncontrollably. This is similar to how athletes often have genes that give them an advantage in terms of strength, speed, or endurance.	oncogenes	Using an analogy, explain oncogenes to student who likes sports.
Think of oncogenes as the players on a sports team. They are the ones who make things happen and help the team win. In cancer, oncogenes can become mutated and start to work too well, causing tumors to form.	oncogenes	Using an analogy, explain oncogenes to student who likes sports.
Oncogenes are like the players on a sports team. They help the cell to grow and divide. Cancer can develop when these genes become damaged or mutated, causing the cells to keep dividing even when they shouldn't.	oncogenes	Using an analogy, explain oncogenes to student who likes sports.
If tumor suppressor genes are the referees of a game, they make sure that all the players are following the rules and that no one is getting too rough. They help to keep everything in check. Similarly, tumor suppressor genes help to keep cells from becoming cancerous by repairing any damage that may occur and stopping them from dividing too quickly.	tumor suppressor genes	Using an analogy, explain tumor suppressor genes to student who likes sports.
Tumor suppressor genes are like the referees of a sporting event. They make sure that everything is fair and no one gets an unfair advantage. In the same way, tumor suppressor genes keep cells from growing out of control and becoming tumors.	tumor suppressor genes	Using an analogy, explain tumor suppressor genes to student who likes sports.
Tumor suppressor genes are like the referees in a football game. They make sure that the game is fair and that all the players are following the rules. If one of the players starts to cheat, the referee will step in and correct them. tumor suppressor genes do the same thing in our bodies; they make sure that cells are behaving properly and not becoming cancerous.	tumor suppressor genes	Using an analogy, explain tumor suppressor genes to student who likes sports.
If software is brittle, it means that it does not handle changes or errors very well. For example, imagine if you were playing a sport like basketball and the hoop broke off of the backboard. If the hoop was metal and strong, it would be able to withstand being hit by the ball. However, if the hoop was made out of thin plastic, it would break easily when hit by the ball. In this analogy, the metal hoop represents robust software while the plastic hoop represents brittle software.	brittle software	Using an analogy, explain brittle software to student who likes sports.
If you think of software as being like a football, it is strong and can take a lot of abuse. But if you think of software as being like a crystal vase, it is very brittle and can break easily.	brittle software	Using an analogy, explain brittle software to student who likes sports.
Brittle software can be compared to a brittle bone. Just as with bones, if the software is handled incorrectly or too much pressure is applied, it will snap. This means that the software is not very resilient and can easily break when pushed too hard or used in an incorrect way.	brittle software	Using an analogy, explain brittle software to student who likes sports.
A resonance hybrid is like a team of athletes who can each play different sports. Each athlete can run, jump, and throw the ball well. But when they come together as a team, they are even better than the sum of their individual parts. The same is true for molecules. When atoms bond together to form molecules, the electrons in those bonds can move around and interact with each other. This creates new energy levels that are not found in any of the individual atoms. These new energy levels are called resonances, and they make the molecule stronger and more stable than any of the atoms would be on their own.	resonance hybrid	Using an analogy, explain resonance hybrid to student who likes sports.
A resonance hybrid is like a basketball team. The players on the team (the orbitals) work together to score points and win the game.	resonance hybrid	Using an analogy, explain resonance hybrid to student who likes sports.
When two opposing teams play each other in a sport, there is usually one player on each team who is very good at that particular sport. For example, one player may be able to throw the ball really well and another player may be able to catch the ball well. These players are said to have resonance with each other because their skills complement each other. In the same way, atoms can have resonance hybrid orbitals if they have similar energy levels.	resonance hybrid	Using an analogy, explain resonance hybrid to student who likes sports.
A wave mechanical model can be thought of as a sports game. In this analogy, the particles in a substance are the players on the field. The waves that pass through the substance are like the ball being passed back and forth between players. The faster the waves move, the more exciting (and energetic) the game becomes!	wave mechanical model	Using an analogy, explain wave mechanical model to student who likes sports.
The wave mechanical model of a molecule is like the movement of a large sports crowd. Just as people in the crowd move up and down, forward and back as they cheer on their favorite team, so too do molecules move up and down, and back and forth as they vibrate.	wave mechanical model	Using an analogy, explain wave mechanical model to student who likes sports.
The wave mechanical model of a molecule can be thought of as being similar to the waves that are created when a stone is thrown into a pond. The molecules in the gas or liquid are constantly moving around and creating these waves. The size of the wave depends on how much energy is put into it.	wave mechanical model	Using an analogy, explain wave mechanical model to student who likes sports.
An electroencephalogram (EEG) is a test that measures the electrical activity of your brain. This test can help doctors find out if you have a problem with your brain, such as a seizure or tumor.	electroencephalogram	Using an analogy, explain electroencephalogram to student who likes sports.
An electroencephalogram is like a sports scoreboard. It shows how well the game is going by tracking the number of points scored by each team. In the same way, an EEG tracks the number of electrical impulses being sent between different parts of your brain.	electroencephalogram	Using an analogy, explain electroencephalogram to student who likes sports.
An electroencephalogram (EEG) is a test used to measure the electrical activity of your brain. This test can be used to help diagnose problems with your brain, such as seizures. During this test, electrodes will be placed on your scalp. These electrodes will then record the electrical signals that are produced by your brain.	electroencephalogram	Using an analogy, explain electroencephalogram to student who likes sports.
DNA replication is like a sports team practicing. The team gets better at playing together and they are able to win more games. DNA replication is also like a factory. The factory produces more cars and this helps the company sell more cars.	dna replication	Using an analogy, explain dna replication to student who likes sports.
Let's say you are a professional basketball player. You have worked hard all your life to become the best player you can be. To keep getting better, you need to continue practicing and improving your skills. The same is true for your cells - they need to keep practicing replication in order to stay healthy and function properly.	dna replication	Using an analogy, explain dna replication to student who likes sports.
 DNA replication is similar to a sports team. The players on the team are the nucleotides, and they work together to create new copies of the original team. Just like in sports, there can be mistakes made during replication, which can lead to genetic mutations. However, with proper training and practice, the chances of making mistakes are minimized.	dna replication	Using an analogy, explain dna replication to student who likes sports.
RNA transcription is similar to a sports commentator talking about the game. The commentator takes information from what is happening on the field and relays it back to the audience in an easy-to-understand way. In the same way, RNA transcribes genetic information from DNA so that it can be used by cells.	rna transcription	Using an analogy, explain rna transcription to student who likes sports.
Rna transcription can be explained as the process of creating a "copy" of a gene's instructions so that it can be used to create a protein. This process is similar to how teams in sports create copies (or "transcriptions") of plays in order to use them during the game.	rna transcription	Using an analogy, explain rna transcription to student who likes sports.
Rna transcription is like a sports announcer reading the play-by-play of a game. The announcer is telling the audience what is happening moment by moment, describing the action as it unfolds. In the same way, rna transcription reads the genetic information in dna and relays it to other parts of the cell that need it.	rna transcription	Using an analogy, explain rna transcription to student who likes sports.
Protein translation is similar to sports because proteins are like athletes and the ribosomes are like the coaches. The athletes need someone to tell them what to do and how to do it, and that is where the coaches come in. They give instructions to the athletes (proteins) on what they need to do in order to win (become functional).	protein translation	Using an analogy, explain protein translation to student who likes sports.
The process of protein translation is a lot like the game of soccer. The rules state that each team has 11 players on the field at any given time. Just as in soccer, there are specific instructions that need to be followed in order for the protein translation process to work correctly. These instructions are encoded within the sequence of nucleotides in the gene and must be read by the translator (ribosome) in order to produce a functioning protein. Like a player on a soccer team, different amino acids can be assigned to each position along the peptide chain depending on what is needed for correct function. This process is repeated over and over again until the entire protein has been produced.	protein translation	Using an analogy, explain protein translation to student who likes sports.
Protein translation is like a football game. The players are the proteins and the field is the cell. The coach is the mRNA and the instructions for how to play the game are written on his clipboard (the DNA). When he wants one of his players to run onto the field, he calls them over and tells them what to do. The player then goes out onto the field and tries their best to carry out the coach's instructions.	protein translation	Using an analogy, explain protein translation to student who likes sports.
An ecosystem is like a sports team. The players (plants and animals) work together to achieve a common goal (survival). The environment (the climate, the soil, the water) provides the resources that the players need to succeed. Just as in sports, there can be winners and losers in ecosystems.	ecosystem	Using an analogy, explain ecosystem to student who likes sports.
An ecosystem can be thought of as a sports team. The players (organisms) all work together to achieve a common goal - winning the game. The environment (the playing field and everything around it) provides the necessary resources for the players to thrive and succeed.	ecosystem	Using an analogy, explain ecosystem to student who likes sports.
An ecosystem is like a sports team. The players (organisms) work together to achieve a common goal (survival). They need each other to succeed. The environment provides the resources they need to play and survive. And, just like in sports, when one part of the ecosystem changes, it can have a ripple effect throughout the rest of the system.	ecosystem	Using an analogy, explain ecosystem to student who likes sports.
When an athlete makes a move on the playing field, their muscles contract. This contraction is caused by action potentials that start in the brain and travel down the spinal cord to the muscle. The action potentials are like a wave of energy that causes the muscle to contract.	propagation of an action potential down a neuron	Using an analogy, explain propagation of an action potential down a neuron to student who likes sports.
When an athlete makes a move on the playing field, this action doesn't happen in just one place. For example, when an athlete jumps to spike the ball, they are using energy and muscles throughout their body. This coordinated effort starts with movement in their feet and then sends signals through their nervous system to tell their brain what to do. The brain then sends messages back out to the rest of the body telling it what muscles to activate and how hard to work. Just like athletes need coordination between different parts of their bodies, neurons also need communication between different areas in order for an action potential to be generated and propagate down the axon.	propagation of an action potential down a neuron	Using an analogy, explain propagation of an action potential down a neuron to student who likes sports.
An action potential is kind of like a runner. Once the runner (action potential) gets going, it's hard to stop it. The same thing happens with an action potential down a neuron. It starts at the synapse and keeps going until it reaches the end of the neuron.	propagation of an action potential down a neuron	Using an analogy, explain propagation of an action potential down a neuron to student who likes sports.
A frog's breathing mechanism is a lot like how we breathe. We inhale (breathe in) oxygen and then exhale (breathe out) carbon dioxide. Frogs do the same thing! They suck in air through their nostrils and then push it out of their mouths.	breathing mechanism of frogs	Using an analogy, explain breathing mechanism of frogs to student who likes sports.
Breathing is like the intake and release of air in a car engine. The frog's lungs are like the cylinders in the engine, and the frog's diaphragm is like the piston. When the diaphragm contracts, it pulls downward on the lungs, creating a vacuum that sucks air into them. When the diaphragm relaxes, it pushes upward on the lungs, expelling carbon dioxide-laden air.	breathing mechanism of frogs	Using an analogy, explain breathing mechanism of frogs to student who likes sports.
When you breathe in, your lungs take in oxygen from the air. The oxygen is then sent to all of the cells in your body. When you breathe out, carbon dioxide is released from your body.	breathing mechanism of frogs	Using an analogy, explain breathing mechanism of frogs to student who likes sports.
In sports, there are different layers of players. The first layer is the team's starting lineup. This is the group of players who play at the beginning of the game. They are typically the best players on the team. The second layer is made up of substitutes. These are players who come in to replace injured or tired starters. The third layer is made up of benchwarmers. These areplayers who don't usually see any playing time during a game.	layered architecture	Using an analogy, explain layered architecture to student who likes sports.
A layered architecture for a sports team would be one where the players are divided up by position. There would be a layer of quarterbacks, a layer of running backs, and so on. This would allow each player to specialize in their particular role and help the team work together more effectively.	layered architecture	Using an analogy, explain layered architecture to student who likes sports.
An example of layered architecture in sports would be the way a football team is organized. The quarterback, linemen, and running backs are all part of the offensive layer. The defensive line, linebackers, and defensive backs are all part of the defensive layer. Finally, there is the special teams layer which includes players like kickers and punters.	layered architecture	Using an analogy, explain layered architecture to student who likes sports.
In many sports, there are rules that prohibit players from doing certain things in order to make the game fair and more enjoyable to watch. For example, in football, a player cannot run with the ball for more than 10 yards without either passing or being tackled. This rule is in place to prevent one team from running away with the game. The same is true for chemical reactions. In order to keep things fair, we have to put limitations on how much of each reactant can be used. This limiting reactant ensures that all of the reactants are used up and no product is created in excess.	limiting reactant and excess reactant	Using an analogy, explain limiting reactant and excess reactant to student who likes sports.
A limiting reactant is like the referee in a sports game. The referee determines how much of each sport can be played. In the same way, a limiting reactant determines how much of a chemical reaction can take place. An excess reactant is like one of the players on the field. It's not as important as the referee, but it still helps to move things along.	limiting reactant and excess reactant	Using an analogy, explain limiting reactant and excess reactant to student who likes sports.
In sports, there are often times when each team has a certain number of players on the field. If one team has more players than the other team, then they have an excess of players. The other team only has as many players as they need to cover all the bases (or whatever sport is being played). This would be similar to a limiting reactant. A limiting reactant is a substance that limits how much product can be formed in a chemical reaction. In other words, it's the thing that's used up first and prevents any further reaction from happening.	limiting reactant and excess reactant	Using an analogy, explain limiting reactant and excess reactant to student who likes sports.
A eukaryotic cell can be thought of as a team of highly specialized athletes working together to win the game. The players (proteins) have specific jobs and work together to carry out the team's strategy.	eukaryotic cell	Using an analogy, explain eukaryotic cell to student who likes sports.
A eukaryotic cell can be thought of as an extremely complex sports stadium. The stadium has many different sections (organs), each with their own specialized role in supporting the overall function of the stadium. The walls and roof of the stadium keep out the elements, while a sophisticated heating, cooling, and ventilation system ensures that spectators remain comfortable no matter what the weather is like outside. There are security personnel to protect against intruders, ticket-takers and ushers to help spectators find their seats, concession stands for hungry fans, and even a Jumbotron to keep everyone up-to-date on the action. Like a well-run sports stadium, a eukaryotic cell is incredibly complex and highly organized, with each part working together to ensure that the whole organism functions effectively.	eukaryotic cell	Using an analogy, explain eukaryotic cell to student who likes sports.
A eukaryotic cell is like a professional sports team. They have many players working together to achieve a common goal. The players are all specialized in their own way and work together to make the team successful.	eukaryotic cell	Using an analogy, explain eukaryotic cell to student who likes sports.
A prokaryotic cell is like a sports team. It has players (proteins) who work together to carry out the team's goals (cellular processes). The coach (the DNA) tells them what to do and how to do it.	prokaryotic cell	Using an analogy, explain prokaryotic cell to student who likes sports.
A prokaryotic cell can be thought of as a small, independent sports team. This team is responsible for all aspects of its own operations, from training and coaching to game strategy and player salaries. Like any good sports team, the players on a prokaryotic cell work together towards a common goal: survival.	prokaryotic cell	Using an analogy, explain prokaryotic cell to student who likes sports.
A prokaryotic cell can be thought of as an individual player on a sports team. Just like each player has a specific role to play in order for the team to be successful, each prokaryotic cell has a specific role within the organism.	prokaryotic cell	Using an analogy, explain prokaryotic cell to student who likes sports.
An operating system kernel is like the quarterback of a football team. The kernel handles all the important tasks that keep the computer running, such as managing memory and files, handling input and output, and starting other programs. Just as a good quarterback needs to be able to run well, pass accurately, and make smart decisions on the field, a good kernel needs to be efficient in its use of resources, handle complex operations quickly, and provide features that users need or want.	operating systems kernel	Using an analogy, explain operating systems kernel to student who likes sports.
An operating system's kernel is like the quarterback of a football team. It's responsible for making sure all the other players are doing their jobs correctly and efficiently, and it coordinates all the activity on the field. In addition, the quarterback can also make things happen himself by running or throwing the ball. Just like a good quarterback, a well-designed kernel should be efficient, reliable, and unobtrusive - letting applications run smoothly without getting in their way.	operating systems kernel	Using an analogy, explain operating systems kernel to student who likes sports.
An operating system kernel is like the quarterback of a football team. It is responsible for coordinating the activities of all the other players on the field and directing the flow of play. Similarly, the kernel oversees all activity on a computer, managing resources and ensuring that applications run smoothly.	operating systems kernel	Using an analogy, explain operating systems kernel to student who likes sports.
A limiting reactant can be thought of as the "final boss" in a sporting event. Just like in any competition, there is only so much time and space available to complete the task at hand. In this analogy, the athletes are trying to beat the clock (or score against their opponent) while using up as little of the limited resources as possible. The athlete who manages to do this best is typically the one who comes out on top.	limiting reactant	Using an analogy, explain limiting reactant to student who likes sports.
A limiting reactant is the amount of a particular chemical that is needed to complete a reaction. In other words, it's the "end-point" for a reaction. For example, in sports, if one team has more players than the other, then the other team will be at a disadvantage. The same concept applies to chemistry - if there isn't enough of one chemical present in a reaction mixture, then the reaction won't proceed as planned.	limiting reactant	Using an analogy, explain limiting reactant to student who likes sports.
In sports, there are always a certain number of players on the playing field at once. If one team has more players than the other team, the first team will have an advantage. The same concept applies to chemistry. In a chemical reaction, there are only so many atoms or molecules that can participate in the reaction at any given time. The reactant that runs out first is called the limiting reactant.	limiting reactant	Using an analogy, explain limiting reactant to student who likes sports.
Helicase can be thought of as the player on a team who is always sprinting up and down the field. This enzyme helps to unravel the DNA double helix so that it can be read by other proteins.	helicase	Using an analogy, explain helicase to student who likes sports.
Helicase is a protein that helps unzip the double helix structure of DNA so that it can be copied. It works like a zipper, separating the two strands of DNA and then "zipping" them back up again when done. Like athletes who use their muscles to move quickly and powerfully, helicase uses its power to help copy DNA quickly and accurately.	helicase	Using an analogy, explain helicase to student who likes sports.
Helicase is a lot like a sports referee. It is responsible for making sure the game progresses smoothly and that all the players are following the rules. In addition, helicase helps to create new strands of DNA by unwinding them from old strands.	helicase	Using an analogy, explain helicase to student who likes sports.
Dna replication binding proteins can be compared to sports referees. These proteins help ensure that the genetic instructions are accurately copied during cell division. They bind to specific sections of dna and help keep it stable while the cells divide.	dna replication binding proteins	Using an analogy, explain dna replication binding proteins to student who likes sports.
Replication binding proteins are like the referees in a sports game. They make sure that all of the players are following the rules and that the game is fair. In DNA replication, these proteins help to ensure that everything goes smoothly and that all of the DNA is copied accurately.	dna replication binding proteins	Using an analogy, explain dna replication binding proteins to student who likes sports.
If DNA replication proteins are like the players on a sports team, then the DNA molecule would be the ball. The players need to be close to the ball in order to play effectively. In the same way, the DNA replication proteins need to bind tightly to the DNA in order to replicate it accurately.	dna replication binding proteins	Using an analogy, explain dna replication binding proteins to student who likes sports.
Ligase is like the glue that helps hold things together. In sports, ligase would be like the glue that helps keep the players' muscles and bones together. Without ligase, injuries would be more common since the players' muscles and bones would not be as stable.	ligase	Using an analogy, explain ligase to student who likes sports.
Ligase can be thought of as the glue that helps to hold DNA together. It is a type of enzyme that helps to join pieces of DNA together, forming one continuous strand. This process is important for repairing damaged DNA, and also for helping cells divide and grow.	ligase	Using an analogy, explain ligase to student who likes sports.
Ligase is like the glue that holds things together. In sports, it would be responsible for holding the players together as a team and keeping them working towards the same goal.	ligase	Using an analogy, explain ligase to student who likes sports.
Process control block can be thought of as a quarterback in American football. The quarterback is responsible for making sure that the offensive play goes smoothly. If something goes wrong, the quarterback needs to be able to make adjustments on the fly. The same is true for process control blocks in a manufacturing or processing plant. They are responsible for ensuring that the production process runs smoothly and efficiently.	process control block	Using an analogy, explain process control block to student who likes sports.
A process control block, or PCB, is like the quarterback of a football team. The PCB is in charge of making sure that all of the players are doing their jobs correctly and efficiently. If something goes wrong, it's up to the PCB to make adjustments so that the team can succeed.	process control block	Using an analogy, explain process control block to student who likes sports.
If we imagine the control of a process as being like the control of a sports game, then think about what is happening during the game. There are people who are directing and controlling what is happening on the field or court. They make sure that things happen in an orderly way and that players follow the rules. In much the same way, those who operate a process need to have some sort of control over it so that it runs smoothly and according to plan. The control block helps to provide this necessary level of direction for industrial processes.	process control block	Using an analogy, explain process control block to student who likes sports.
Encoding is similar to translating a word from one language to another. The translator needs to understand both languages in order to encode the message accurately. Similarly, a computer needs to understand the code that is being used in order to decode the message.	message encoding	Using an analogy, explain message encoding to student who likes sports.
Encoding a message is very similar to sending a ball through a hoop. The sender must first put the message in a format that can be understood by the recipient. Just as there are many different types of hoops, there are also many different ways to encode messages. Once the message is in the correct format, it is sent like a ball flying through the air towards its destination.	message encoding	Using an analogy, explain message encoding to student who likes sports.
Message encoding is like when you fill out a bracket for the NCAA tournament. You are taking all of the teams and putting them into groups (the conferences) and then picking which team will win each game. Message decoding is like when you are watching the games and filling in your bracket as you go.	message encoding	Using an analogy, explain message encoding to student who likes sports.
Drugs and receptor sites interact in a way that can be compared to two athletes competing against each other. The drug is the athlete, while the receptor site is the opponent. In order for the drug to win, it must overpower and block the receptor site.	interaction between drugs and receptor sites	Using an analogy, explain interaction between drugs and receptor sites to student who likes sports.
Think of receptor sites as being like different spots on a basketball court. The drug is like the ball, and when it comes into contact with a receptor site, it "bounces off" and does something to the cell. Each type of receptor site responds differently to each type of drug, just as each spot on the basketball court responds differently to a different kind of ball.	interaction between drugs and receptor sites	Using an analogy, explain interaction between drugs and receptor sites to student who likes sports.
When two athletes compete in a sport, they are both trying to use their physical abilities to win. The same is true for drugs and receptor sites. The drug is trying to bind to the receptor site so that it can have an effect on the body. The more effectively the drug can bind to the receptor site, the more powerful its effects will be.	interaction between drugs and receptor sites	Using an analogy, explain interaction between drugs and receptor sites to student who likes sports.
A monitor is a large screen in a room that shows what is happening in the room. It is like a TV, but it is larger.	monitor	Using an analogy, explain monitor to student who likes sports.
Your computer monitor is like a sports scoreboard. It shows you the score of the game, as well as other information like who is playing and how much time is left in the game.	monitor	Using an analogy, explain monitor to student who likes sports.
A monitor is like a referee in sports. They make sure the game is fair and that both teams are playing by the rules.	monitor	Using an analogy, explain monitor to student who likes sports.
A CPU (central processing unit) is like the quarterback of a football team. The CPU is responsible for making all of the important decisions for the team, such as who to throw to and when to run the ball.	cpu	Using an analogy, explain cpu to student who likes sports.
The CPU is like a quarterback in American football. It's responsible for making all the important strategic decisions on the field, such as which plays to run and when to call them.	cpu	Using an analogy, explain cpu to student who likes sports.
CPU is like the quarterback of a football team. It is responsible for making all the important decisions, such as who to throw the ball to and when to run or pass.	cpu	Using an analogy, explain cpu to student who likes sports.
The motherboard is the central component of a computer. It holds all of the other components in place and allows them to communicate with each other. It is like the brain of the computer, telling everything what to do.	motherboard	Using an analogy, explain motherboard to student who likes sports.
The motherboard can be thought of as the spine of a sportsperson. It is responsible for connecting all the different muscles, nerves and organs together. The motherboard is also essential for transmitting messages between different parts of the body. Just like in a computer, if the motherboard was to fail, then everything else would stop working too.	motherboard	Using an analogy, explain motherboard to student who likes sports.
When you think about a motherboard in the context of sports, it might be helpful to think about it as the foundation or backbone of an organization. Just as a motherboard provides the essential connections and infrastructure for a computer system, a team's management and players need to be well-coordinated in order to achieve success. In other words, the motherboard is what makes everything work together smoothly.	motherboard	Using an analogy, explain motherboard to student who likes sports.
Ram is like a running back in football. He is fast and powerful. He can run through defenders and get the ball into the end zone.	ram	Using an analogy, explain ram to student who likes sports.
Ram is the name of a football play in which the quarterback hands off to a running back, who then runs through an opening in the offensive line.	ram	Using an analogy, explain ram to student who likes sports.
Ramming is a type of football play where the offensive player charges forward with the ball, attempting to run through or past defenders.	ram	Using an analogy, explain ram to student who likes sports.
A power supply unit is like the fuel tank in a car. It supplies power to the other parts of the car so that it can run. The power supply unit in a computer is responsible for supplying electricity to all of the components inside the computer.	power supply unit	Using an analogy, explain power supply unit to student who likes sports.
A power supply unit is like the fuel tank in a car. It provides the energy that allows the engine to run. In a computer, the power supply unit converts AC voltage from the wall outlet into DC voltage that is used by the computer's components.	power supply unit	Using an analogy, explain power supply unit to student who likes sports.
A power supply unit in a sports context would be like the team's manager. He or she is responsible for making sure that the players have what they need to succeed (e.g., water, food, equipment, etc.) and are organized in a way that allows them to compete effectively.	power supply unit	Using an analogy, explain power supply unit to student who likes sports.
A keyboard is like a set of golf clubs. They are both tools that can be used to help you do something better. A keyboard can be used to write faster and more easily than you could by hand. Golf clubs can help you hit the ball farther and straighter than you could without them.	keyboard	Using an analogy, explain keyboard to student who likes sports.
If you like sports, think of the keyboard as a basketball court. The letters and numbers are the baskets, and your fingers are the players. When you type on the keyboard, your fingers are shooting hoops!	keyboard	Using an analogy, explain keyboard to student who likes sports.
A keyboard is like a soccer field. The keys are the playing surface and the players (your fingers) move around on the keys to control the ball (the cursor).	keyboard	Using an analogy, explain keyboard to student who likes sports.
A mouse is a small rodent that is typically used as a pet. They are known for their ability to climb and jump, which can make them hard to catch. Mice also have a keen sense of smell, which helps them find food and avoid danger.	mouse	Using an analogy, explain mouse to student who likes sports.
A mouse is a small rodent that is commonly used as a pet. They are known for their agility and ability to jump high. Mice typically live in fields, forests, or farms where they can find food and shelter.	mouse	Using an analogy, explain mouse to student who likes sports.
Mouse is a computer input device that is used to control the movement of the cursor on the screen. It can be moved around by hand and clicks on buttons or icons with its built-in button.	mouse	Using an analogy, explain mouse to student who likes sports.
An audio card is like a microphone for your computer. It allows you to listen to music, talk on the phone, and watch movies with sound.	audio card	Using an analogy, explain audio card to student who likes sports.
An audio card is similar to a player on a sports team. The card helps the computer understand the instructions sent by the game developer, and then outputs sound through the speakers or headphones.	audio card	Using an analogy, explain audio card to student who likes sports.
An audio card is like a microphone used by sports announcers to commentate on games. It captures the sound of the game and allows for commentary to be added in real-time.	audio card	Using an analogy, explain audio card to student who likes sports.
A video card is a bit like a sports car. It's designed to do one thing really well - in this case, render graphics quickly and smoothly. Just as you wouldn't expect a Ferrari to be great at hauling hay bales, you don't want to use the same video card for gaming that you would use for photo editing.	video card	Using an analogy, explain video card to student who likes sports.
A video card is like the quarterback on a football team. They are in charge of telling everyone what to do and making sure everything runs smoothly. A good video card will make your games run faster and look better.	video card	Using an analogy, explain video card to student who likes sports.
A video card can be thought of as the quarterback on a football team. They are responsible for all of the important decisions made during a game and need to have an understanding of all aspects of the sport in order to be successful. In much the same way, a video card needs to have a good understanding of how graphics work in order to create an attractive and smooth display for games or videos.	video card	Using an analogy, explain video card to student who likes sports.
In order to calculate the age of a tree, you would have to measure how much the tree has grown since it was planted. You would then take this measurement and divide it by the amount that the average tree grows in a year. This will give you an estimate for how old the tree is.	tree's age calculation	Using an analogy, explain tree's age calculation to student who likes sports.
It is a little bit like keeping score in a game of tennis. You keep track of how many times each player has hit the ball, and then at the end you can calculate who won based on who had more hits. With trees, we measure how much new wood has been added to the tree over time (the number of growth rings), and then we can calculate its age by counting back from the present day.	tree's age calculation	Using an analogy, explain tree's age calculation to student who likes sports.
When you are tracking the age of a tree, think of it as being like a runner in a race. The amount of time that has passed since the tree was planted is its "birthdate." Every year afterward is another lap around the track. So, if the tree was planted on January 1st and it's now July 1st, then that means the tree has completed six laps (since January 1st is day number 365).	tree's age calculation	Using an analogy, explain tree's age calculation to student who likes sports.
Glycolysis is a process that breaks down glucose (sugar) in the body to create energy. This process is similar to what happens when you run a marathon. When you are running, your muscles need energy to keep going. The sugar in your blood stream provides this energy and it is broken down by glycolysis.	glycolysis	Using an analogy, explain glycolysis to student who likes sports.
Glycolysis is the process that breaks down glucose (sugar) in the body to produce energy. This process happens when you are working out and need energy to power your muscles. The sugar is broken down into a molecule called ATP, which provides the energy for your muscles to work.	glycolysis	Using an analogy, explain glycolysis to student who likes sports.
Glycolysis is like the process of taking a goal in soccer. When you score a goal, the ball goes through a number of different steps before it ends up in the back of the net. Similarly, glycolysis takes glucose (the ball) and breaks it down into pyruvate (the goal).	glycolysis	Using an analogy, explain glycolysis to student who likes sports.
When light or any other type of wave encounters an obstacle, part of the wave is reflected off the obstacle and part is transmitted through it. If the obstacle is very small compared to the wavelength of the wave, most of the energy will be reflected. This process is called reflection. If the obstacle is large compared to the wavelength, most of the energy will be transmitted. This process is called transmission. When a wave encounters an object that has a different refractive index than its surroundings, some of the energy will be absorbed by the object and some will be scattered in all directions. The amount of scattering depends on how big or small the object is compared to the wavelength and on how much difference there is between refractive indices of materials surrounding objects and objects themselves.	anti-stokes scattering	Using an analogy, explain anti-stokes scattering to student who likes sports.
Anti-stokes scattering can be thought of as the opposite of a tennis ball bouncing off a racket. In anti-stokes scattering, the energy from the photon is transferred to an electron, which then radiates away its excess energy as heat.	anti-stokes scattering	Using an analogy, explain anti-stokes scattering to student who likes sports.
Anti-Stokes scattering is much like the defensive end in a football game. The defensive end tries to block the opposing team's quarterback from throwing the ball, and anti-Stokes scattering tries to block light from escaping from a material. Just as the quarterback can still throw the ball even if the defensive end blocks him, light can still escape from a material even if anti-Stokes scattering diminishes its intensity.	anti-stokes scattering	Using an analogy, explain anti-stokes scattering to student who likes sports.
Stokes scattering is like when a quarterback throws the ball to a receiver. The quarterback gives the ball some speed and then at the last second, he pulls his arm back and releases the ball. This causes the ball to spin around as it moves through the air. When it gets close to the receiver, he catches it and then runs downfield with it.	stokes scattering	Using an analogy, explain stokes scattering to student who likes sports.
Stokes scattering is a process that happens when light hits an object and bounces off of it. This can be compared to the way a ball would bounce off of a wall. The difference is that light doesn't always bounce in the same direction. Some of the light will scatter in all directions, while some may be scattered in specific directions based on the shape and texture of the object.	stokes scattering	Using an analogy, explain stokes scattering to student who likes sports.
Stokes scattering is the process of light bouncing off a surface and returning in a new direction. This analogy can be used to explain how this works with sports. When a ball is thrown or kicked, it will bounce off the ground and return to the player. The same thing happens with light; when it hits a surface, it will bounce off and return in a new direction.	stokes scattering	Using an analogy, explain stokes scattering to student who likes sports.
The median lethal dose is the amount of a particular drug or chemical that will kill 50 percent of the people who take it. It can be thought of as the "average" dose needed to kill someone, since it falls in the middle of all the doses that have been tested. For example, if a football player takes 100 milligrams of a certain drug and dies, then you could say that the median lethal dose for that drug is 100 milligrams.	median lethal dose	Using an analogy, explain median lethal dose to student who likes sports.
If someone takes a lethal dose of a drug, it means that they will die as a result of taking the drug. The median lethal dose is the amount of the drug that is needed to kill 50% of people who take it. In other words, it's the dose that is deadly for half of those who use it.	median lethal dose	Using an analogy, explain median lethal dose to student who likes sports.
The median lethal dose is the dose of a substance that kills half of those exposed to it. In other words, it is the amount of a drug or poison required to kill 50% of those who take it. For example, if someone takes 10 ml of a particular pesticide, and 5 people die as a result, then the median lethal dose for that pesticide would be 10 ml.	median lethal dose	Using an analogy, explain median lethal dose to student who likes sports.
The universe is like a gigantic sports stadium. It's huge and there are lots of things going on inside it. There are games happening all the time, with different teams playing against each other. Some games are more important than others, but they're all part of the stadium experience. The universe is also full of spectators - billions and billions of them! They come from all over to watch the games, and some even have their own seats in the stadium.	universe	Using an analogy, explain universe to student who likes sports.
The universe can be thought of as a large sporting event. It is made up of many smaller events (planets, stars, etc.), and each one has its own set of rules. Some are more exciting than others, and some last longer than others. But in the end, they all come to an end.	universe	Using an analogy, explain universe to student who likes sports.
The universe is like a sports game. There are many different players (planets, stars, etc.), and they all work together to create an exciting and complex event. Just like in any sport game, there are ebbs and flows to the action, with moments of high excitement and others that are more subdued. The universe is always changing, so there's always something new to experience!	universe	Using an analogy, explain universe to student who likes sports.
Enzymes are like the referees in a sporting event. They ensure that the game is played fairly and according to the rules. In the same way, enzymes make sure that all of the chemical reactions taking place inside of our cells happen correctly and without any interference.	enzyme mechanism	Using an analogy, explain enzyme mechanism to student who likes sports.
Enzymes are like athletes in that they are very active and need energy to do their work. The "fuel" for enzymes is the food we eat. Enzymes digest food by breaking it down into smaller pieces. This process is called digestion, and it happens in our stomachs and intestines. Digestion is made possible by enzymes, which are produced by special cells in our digestive system.	enzyme mechanism	Using an analogy, explain enzyme mechanism to student who likes sports.
When I was younger, I loved playing sports. My favorite game to play was basketball. In order for me to be successful at the game, I needed to use my skills and abilities in the right way. This is similar to how enzymes work inside our body. The enzymes need to be in the right place and use their skills (the ability to catalyze) in order for us to be healthy and function correctly.	enzyme mechanism	Using an analogy, explain enzyme mechanism to student who likes sports.
Anova is a statistical technique that is used to compare the means of two or more groups. It does this by testing the null hypothesis that there is no difference between the means of the groups. This test is done using an F-statistic.	anova	Using an analogy, explain anova to student who likes sports.
ANOVA is like when the NBA looks at how well each team performs in their conference. They look at each team's record and then compare them to the other teams in their conference. This gives them an idea of how each team is doing compared to the others.	anova	Using an analogy, explain anova to student who likes sports.
The two types of anova that we use most commonly in statistics are the one-way anova and the two-way anova. The one-way anova is used when you have a single factor (independent variable) with more than two levels, while the two-way anova is used when you have two factors (independent variables), each with more than two levels. In both cases, the goal is to determine whether there is a difference among the means of the different groups or levels. For example, if you were doing a one-way anova on test scores for three different classes, your goal would be to see if there was a difference in mean test scores among the three classes. If there was a difference, you would then want to know which class had the highest mean score and which class had the lowest mean score.	anova	Using an analogy, explain anova to student who likes sports.
A thermostat is a device that regulates the temperature in a room. It does this by turning on or off the furnace, depending on whether the temperature in the room falls below or exceeds the set point. Thermostats are used in many different applications, including home heating and cooling systems, factories, and cars.	thermostat	Using an analogy, explain thermostat to student who likes sports.
A thermostat is a device that helps to control the temperature in a room. It does this by sensing the current temperature and then sending a signal to the furnace or air conditioner to turn on or off as needed.	thermostat	Using an analogy, explain thermostat to student who likes sports.
A thermostat is a device used to control the temperature of a room. It does this by detecting the temperature and turning on or off the heating or cooling system as needed.	thermostat	Using an analogy, explain thermostat to student who likes sports.
Chemical equilibrium is similar to the game of football. In both cases, there are two teams competing against each other and trying to achieve a goal. In chemical equilibrium, the two teams are molecules and atoms that are in a constant battle to see which one will become more stable. The goal of chemical equilibrium is for the two teams to reach a state where neither side can gain an advantage over the other.	chemical equilibrium	Using an analogy, explain chemical equilibrium to student who likes sports.
Chemical equilibrium is much like a game of tug-of-war. In the game, two teams pull on opposite ends of a rope until one team eventually wins. In chemical equilibrium, two substances (like molecules or atoms) are pulling against each other until one substance eventually wins by overpowering the other.	chemical equilibrium	Using an analogy, explain chemical equilibrium to student who likes sports.
Chemical equilibrium is similar to a tie game in sports. In both cases, there is no clear winner and the situation remains unchanged over time.	chemical equilibrium	Using an analogy, explain chemical equilibrium to student who likes sports.
Just-in-time is a production strategy companies use to produce only what is needed, when it is needed. This means that the company does not stockpile goods but produces them as they are ordered by customers. For example, imagine you are a fan of a sporting team. In order to ensure you have a shirt to wear to the next game, the team would need to produce and stock shirts well in advance of the game. However, if the team utilized just-in-time production, it would only produce and stock shirts as orders came in from fans. This would mean that some fans may not be able to get a shirt if they waited until the last minute to order one.	just-in-time	Using an analogy, explain just-in-time to student who likes sports.
If you are a fan of sports, think about the last game you watched. The players didn't bring any basketballs to the court before the game started. They didn't have to because the ball manufacturer made sure that there were enough balls for all of the players and fans in attendance. The same is true for just-in-time manufacturing. Instead of having a large inventory of materials and products sitting on shelves, companies use just-in-time to only produce what is needed when it is needed. This helps reduce costs and save space.	just-in-time	Using an analogy, explain just-in-time to student who likes sports.
Just-in-time is like a professional sports team that has to be ready to play right when the game starts. The players have to know their plays, and they have to be in good shape so they can run around for hours. The equipment has to be working properly, and everyone needs to be on the same page. If something goes wrong during the game, the whole team falls apart.	just-in-time	Using an analogy, explain just-in-time to student who likes sports.
Adaptive immunity can be compared to the body's natural ability to develop antibodies in response to a virus or bacteria. In much the same way that athletes must continually train and push their bodies to new levels of performance, the immune system must also be challenged with new invaders in order to stay sharp. This allows for quick recognition and elimination of invading pathogens before they have a chance to cause harm.	adaptive immunity	Using an analogy, explain adaptive immunity to student who likes sports.
Adaptive immunity can be thought of as athletes who are able to adapt and improve their performance in response to training or competition. In the same way, adaptive immunity is able to respond quickly and effectively to new challenges, such as infections.	adaptive immunity	Using an analogy, explain adaptive immunity to student who likes sports.
Adaptive immunity is like a professional sports team. The players on the team are very good at playing their specific positions. They have been practicing and playing together for a long time. They know what to do when they are on the field.	adaptive immunity	Using an analogy, explain adaptive immunity to student who likes sports.
Just as a pitcher in baseball can throw different speeds by changing how much effort they put into the pitch, an electric current through a wire also has different speeds depending on how much "effort" is put into it. The unit of measure for this effort is called voltage, and like pitching speed, it's measured in volts. Just as there is a relationship between the speed of a pitched ball and the amount of force used to throw it, there is also a relationship between voltage and current. This relationship was discovered by Georg Simon Ohm and is known as Ohm's law: Current = Voltage/Resistance. In other words, if you know any two of these values (current, voltage or resistance), you can calculate the third.	ohm's law	Using an analogy, explain ohm's law to student who likes sports.
Just as a pitcher in baseball must have good control over the speed and movement of the ball he or she throws, an electrician needs to be able to regulate the flow of electricity through wires. Ohm's law states that the amount of current flowing through a wire is directly proportional to the voltage applied to it, and inversely proportional to its resistance. This means that if you increase the voltage (by turning up the power on an appliance for example), you will also increase the amount of current flowing through the wire. And if you decrease the voltage, by turning down a light switch for example, then you will also decrease the current. If you want more current to flow through a wire however, you can just reduce its resistance by making it thicker (or using a higher-voltage source).	ohm's law	Using an analogy, explain ohm's law to student who likes sports.
Ohm's law states that the current through a conductor between two points is directly proportional to the voltage across the points. In other words, if you increase the voltage, then you'll also increase the amount of current flowing through it. This is similar to how in sports, when one team scores more points than their opponents, they're likely to win the game.	ohm's law	Using an analogy, explain ohm's law to student who likes sports.
Transcription is like when a coach talks to their team before the game. The coach is telling them what they need to do and how they need to play in order to win. Transcription is basically the same thing, but instead of coaches talking, cells are listening and then doing what they need to in order to create a protein.	transcription	Using an analogy, explain transcription to student who likes sports.
Transcription is a bit like making a copy of a document. The original is the DNA molecule, and the copy is the RNA molecule. Just as when you make a copy of a paper document, you have an almost identical duplicate, when transcription occurs, the RNA molecule has almost the same sequence of bases as the DNA molecule from which it was copied.	transcription	Using an analogy, explain transcription to student who likes sports.
Transcription is similar to a sport because it takes focus, skill and practice in order to be successful. In transcription, the speaker's words must be accurately written down as they are spoken. This requires concentration and good listening skills. Like any other skill, transcription can be improved through practice - by listening to audio recordings of speeches or interviews and writing out what is said word for word.	transcription	Using an analogy, explain transcription to student who likes sports.
RNA polymerase is like a sports referee. It ensures that the game is played fairly and according to the rules. RNA polymerase helps create new strands of DNA by reading the genetic instructions in DNA and creating a copy of them in RNA.	rna polymerase	Using an analogy, explain rna polymerase to student who likes sports.
RNA polymerase is a lot like the quarterback of a football team. It's responsible for calling the plays and telling all of the other players what to do. RNA polymerase also assembles all of the pieces of DNA into functional proteins.	rna polymerase	Using an analogy, explain rna polymerase to student who likes sports.
RNA polymerase is a bit like the quarterback of a football team. It's responsible for calling the plays and getting the ball moving downfield. In order to do this, it needs some help from other players (enzymes) on the field.	rna polymerase	Using an analogy, explain rna polymerase to student who likes sports.
Ribosomes are like the players on a sports team. The DNA is like the coach, telling the ribosomes what to do. The RNA is like the play-by-play announcer, telling the ribosomes what to do and when to do it. And the proteins are like the athletes, doing all of the work!	ribosome	Using an analogy, explain ribosome to student who likes sports.
Ribosomes are like the referees of a football game. They make sure that all of the players are playing by the rules and keeping things fair. In addition, they also help to create new proteins for the game.	ribosome	Using an analogy, explain ribosome to student who likes sports.
Ribosomes are like the referees of a sports game. They make sure that all of the players are playing by the rules and that the game is fair. Ribosomes also help to create new proteins, which are like the players in a sports game.	ribosome	Using an analogy, explain ribosome to student who likes sports.
Activator protein is a bit like the referee in a sports game. It's responsible for making sure everything runs smoothly and that all of the players are following the rules. In the same way, activator protein helps to ensure that all of the cells in your body are working together as they should be.	activator protein	Using an analogy, explain activator protein to student who likes sports.
Activator protein is like a referee in sports. It helps to ensure that the game is played fairly and that all players are following the rules. In the same way, activator protein helps to make sure that all of the cells in your body are working properly and following the correct set of instructions.	activator protein	Using an analogy, explain activator protein to student who likes sports.
In the world of sports, activator protein would be the player who gets everyone else on the field pumped up and ready to win. This protein is responsible for initiating all the other proteins that will eventually lead to muscle contractions. Without activator protein, no one would be able to achieve their goal - whether it's scoring a touchdown or crossing the finish line first.	activator protein	Using an analogy, explain activator protein to student who likes sports.
Electricity is a lot like sports. In both cases, there are teams (or circuits) of players working together to achieve a common goal. Electricity flows through wires (like athletes run on tracks), and it can be used to power things (like TVs and lights). Just as in sports, there are many different types of electric circuits, each with its own unique setup and rules.	electric circuit	Using an analogy, explain electric circuit to student who likes sports.
When you watch a sports game on TV, the commentators are always talking about the "electricity" of the game. What they mean is that there's a lot of energy and excitement in the air. The same thing happens in an electric circuit. There's a lot of energy flowing through the wires, and it makes everything work.	electric circuit	Using an analogy, explain electric circuit to student who likes sports.
An electric circuit is a lot like a sports game. There are players (like the resistor and the capacitor), and there's a goal (like the lightbulb). The players have to work together in order to achieve the goal. They can't just do their own thing - they need to cooperate. If one player doesn't do his part, then the whole system falls apart.	electric circuit	Using an analogy, explain electric circuit to student who likes sports.
The hydrophobic effect is the tendency of nonpolar molecules to aggregate in water. This can be compared to sports, where nonpolar molecules (players) tend to group together (cluster) when in contact with water (the playing field).	hydrophobic effect	Using an analogy, explain hydrophobic effect to student who likes sports.
The hydrophobic effect can be thought of as a slippery slope. Imagine you are at the top of a hill and trying to sled down it. If the surface is wet, your descent will be slow and difficult because the water will resist your movement. However, if the surface is dry, you will slide down quickly and easily. The hydrophobic effect is responsible for this difference in sliding speed, since water molecules stick together more tightly than non-polar molecules (like those found in oils).	hydrophobic effect	Using an analogy, explain hydrophobic effect to student who likes sports.
The hydrophobic effect can be explained by using the analogy of two people who are wet. One person is wearing a t-shirt and the other person is not. The person without the shirt will feel colder because their skin is in contact with the cold water. The person with the shirt will not feel as cold because their skin is protected from the cold water.	hydrophobic effect	Using an analogy, explain hydrophobic effect to student who likes sports.
When you watch a sporting event, the athletes are constantly sending and receiving signals. For example, when a basketball player jumps up to shoot, they are sending a signal telling their body to contract their muscles as hard as possible to launch themselves into the air. When they reach the top of their jump, they receive a signal from their brain that tells them when to release the ball. This process is called signal transduction.	biological signal transduction	Using an analogy, explain biological signal transduction to student who likes sports.
An athletes body is constantly sending signals to her brain telling it what to do. These signals can be thought of as biological transmission signals. The brain interprets these signals and tells the muscles how to respond. This process is very similar to the way in which a cars computer communicates with its various parts, allowing it to run smoothly. In both cases, there must be a clear line of communication for things to work properly.	biological signal transduction	Using an analogy, explain biological signal transduction to student who likes sports.
In many sports, such as football or basketball, players must react quickly to signals from their coaches in order to make strategic decisions on the field. These signals are transmitted through the air and are picked up by the players' ears. The brain then interprets these signals and sends instructions to the muscles accordingly. This process is known as signal transduction.Similarly, cells in our bodies also receive signals from outside of the cell. These signals can be received by receptors on the cell membrane and then passed along inside of the cell until they reach the nucleus. There, they trigger a series of events that ultimately lead to a change in gene expression. This process is known as signal transduction.	biological signal transduction	Using an analogy, explain biological signal transduction to student who likes sports.
